15,17,17,17,17,17,17,17,17,17,17,17,17,17,17,17
13,14,10,10,10,10,10,10,10,10,10,10,10,10,10,10
13,14,2,2,2,2,2,2,2,2,2,2,2,2,2,2
13,14,2,2,2,2,2,2,2,2,2,2,2,2,2,2
13,14,2,2,2,2,2,2,2,2,2,2,2,2,2,2
13,14,2,2,2,2,2,2,2,2,2,2,2,2,2,2
13,14,2,2,2,2,2,2,2,2,2,2,2,2,2,2
11,11,2,2,2,2,2,2,2,2,2,2,2,2,2,2
42,44,27,28,2,2,4,4,2,2,2,2,2,2,2,2
41,46,21,22,2,2,2,2,2,2,2,1,2,2,2,2
41,46,21,18,34,34,34,34,34,34,34,34,34,34,34,34
41,46,21,18,18,18,18,18,18,18,18,18,18,18,18,18
