1,1,1,1,1,1,1,1,1,1,1,1,1,1,1,1
2,7,1,2,2,2,2,2,2,2,2,6,12,19,6,6
1,7,2,1,2,1,2,2,2,2,2,6,7,6,6,6
2,11,16,2,2,1,2,1,2,1,1,6,7,6,6,6
2,1,11,19,19,19,19,19,19,19,19,19,24,19,13,1
2,1,1,2,2,2,1,2,2,2,2,2,1,2,7,1
1,1,1,2,2,2,1,2,1,1,1,1,1,1,7,2
2,1,2,2,2,2,2,2,2,1,1,1,1,1,7,2
1,1,1,2,2,1,2,1,1,2,1,1,1,2,7,1
1,1,1,2,1,2,2,1,1,1,2,2,2,2,7,2
1,1,1,1,1,1,2,2,1,2,2,1,1,1,7,2
1,1,1,1,1,1,1,1,2,1,2,2,2,2,7,1
