#metadata
world_width,1024
world_height,768
world_tilesize,32
world_name,nigga

#tilemap
1,1,1,1,1,1,1,1,1,1,1,1,1,1,1,1,1,1,1,1,1,1,1,1,1,1,1,1,1,1,1,1
1,1,1,1,1,1,1,1,1,1,1,1,1,1,1,1,1,1,1,1,1,1,1,1,1,1,1,1,1,1,1,1
1,1,1,1,1,1,1,1,1,1,1,1,1,1,1,1,1,1,1,1,1,1,1,1,1,1,1,1,1,1,1,1
1,1,1,2,2,1,2,1,2,1,2,1,1,1,1,1,1,1,1,1,1,1,1,1,1,1,1,1,1,1,1,1
1,1,2,2,1,2,1,1,1,1,2,1,2,1,1,1,2,1,2,2,2,1,1,1,1,1,1,1,1,1,1,1
1,2,1,1,1,2,1,2,2,2,1,2,2,1,2,1,1,1,1,2,1,2,1,1,1,1,1,1,1,1,1,1
1,2,1,1,1,1,1,1,1,2,2,1,1,1,1,2,1,2,1,1,2,1,1,1,1,1,1,1,1,1,1,1
1,2,2,1,2,2,1,2,1,2,2,2,1,2,2,2,1,2,2,2,1,1,1,1,1,1,1,1,1,1,1,1
1,2,2,2,1,1,1,1,2,1,1,2,2,2,1,1,2,1,1,1,2,1,1,1,1,1,1,1,1,1,1,1
1,2,2,1,2,1,1,2,1,2,1,1,1,1,1,2,1,2,1,1,2,1,1,1,1,1,1,1,1,1,1,1
1,1,1,1,1,1,1,1,1,1,2,2,2,1,2,2,2,2,1,2,1,1,1,1,2,1,1,1,1,1,1,1
1,2,1,2,2,2,1,1,1,2,1,1,1,2,2,2,2,2,1,1,1,1,2,1,1,1,1,1,1,1,1,1
1,1,2,2,1,1,1,1,1,1,1,1,1,2,1,2,1,1,1,2,1,1,1,1,1,1,1,1,1,1,1,1
1,1,1,1,1,1,1,2,2,2,1,2,1,1,1,1,2,1,1,1,1,1,1,1,1,1,1,1,1,1,1,1
1,1,1,2,2,1,1,2,2,1,2,2,1,2,2,1,1,1,2,1,1,2,1,1,1,1,1,1,1,1,1,1
1,1,1,1,1,1,2,2,2,2,1,2,2,2,1,2,1,1,2,1,2,1,2,1,1,1,1,1,1,1,1,1
1,1,1,1,1,1,1,1,1,2,1,1,2,1,1,2,2,1,2,1,2,1,1,1,1,1,1,1,1,1,1,1
1,1,1,1,1,1,1,1,1,1,1,1,1,1,1,1,1,1,1,1,1,1,1,1,1,1,1,1,1,1,1,1
1,1,1,1,1,1,1,1,1,1,1,1,1,1,1,1,1,1,1,1,1,1,1,1,1,1,1,1,1,1,1,1
1,1,1,1,1,1,1,1,1,1,1,1,1,1,1,1,1,1,1,1,1,1,1,1,1,1,1,1,1,1,1,1
1,1,1,1,1,1,1,1,1,1,1,1,1,1,1,1,1,1,1,1,1,1,1,1,1,1,1,1,1,1,1,1
1,1,1,1,1,1,1,1,1,1,1,1,1,1,1,1,1,1,1,1,1,1,1,1,1,1,1,1,1,1,1,1
1,1,1,1,1,1,1,1,1,1,1,1,1,1,1,1,1,1,1,1,1,1,1,1,1,1,1,1,1,1,1,1
1,1,1,1,1,1,1,1,1,1,1,1,1,1,1,1,1,1,1,1,1,1,1,1,1,1,1,1,1,1,1,1
